11111111
10PC00001
10E001001
111111111