111111110
10EPC0001
100001001
111111111