111111111
100EPC001
100001000
111111111