111111111
10EPC0001
100001001
1111111111