111111111
100EPC001
100001A01
111111111