1111111111111111111111111111111111
1000000000000000000000000000000001
10P00000CCCCCCCCCCCCCCCCC000000001
1000000010000100000111111000000001
1000000010000100000000001000000001
1000000010000100000000001000000001
1000000010000100000000001000000001
1000000011111110000111111000000001
1000000000000100000100000000000001
1000000000000100000100000000000001
10000000000001000001000000000O0001
1000000000000100000100000000000001
1000000000000100000111111000000001
1000000000000000000000000000000001
1000001111111111111111111110000001
10000000CCCCCCCCCCCCCCCCC000000001
1000000000001111111110000000000001
1000000000000CCCCCCC00000000000E01
1000000000000000000000000000000001
1111111111111111111111111111111111