111111111
100EPC001
10000100z
111111111