111111111
1000EPC01
100001001
1111111A1