111111111
1000E0001
100P01001
111111111