111111111
000EPC001
100001001
111111111