111111111
100EPC001
100001001
11111111